lg1
30 15
X .
3 3 2 2 3 3
XXXXXXXXX.....................
XX......X.....................
.X.....X.......XXXXXXXX.......
..X...X........XXX..XXX.......
...XXX..........X....X........
.X............................
.............................X
............................X.
X.............................
.........XXX..................
.......XXX.XXX................
...XXXXXX...XXXXX.............
..............................
..............................
..............................
